1111111111111
1111000000111
1CCC000000P11
1110000011111
11110000011E1
1111111111111