111111111111
100000000P01
101110000E01
101C10000001
101110000001
111111111111