1111111111111111111111111111111111
100C010111110C00010101111000011111
111000000000000C001111000000000011
11E000000000000C000000000KK0101101
111111CCCCC00000000000000P00011001
11000000000000CCKK0000000000000001
1CKCKCKCKC000000000000000011111111
100000000000001111111110000CKCKC11
1000000000000000000000000000000001
1111111111111111111111111111111111