11111111111111111111111111
10000000000000000CC0000001
11111111000000000111111111
10000000CC00000000C0000001
100000000000CC000000000E01
11111111111000000000000001
10000000000000000000P00001
1111CC00000000000000000011
11110000000001111111000001
1CC00000000000C000C0000001
11111111111111111111111111