111111111111
100000100101
111110001001
111111111111