11111111111111111111111111111
111100000000000000P0000011111
11111111111111000000000000111
11110000000011000000000000001
1111CC00000011CCC000000000001
111111111111111111E1111111111
11111111111111111111111111111
