1111111111111
10010000000C1
10PC011111001
100011EC00001
1111111111111