1111111111
1E00000001
11110000E1
1111111111