111111
1000E1
10P0C1
100001
111111